[       |||   ]
[       |||   ]
[       |||   ]
[       |||   ]
[-------|||   ]
[---------|   ]
[             ]
[       h     ]
[             ]
