[       |||   ]
[       |||   ]
[       |||   ]
[       |||   ]
[-------|||   ]
[---------|   ]
[~~~~~~~~~~~~ ]
[~~~~~~~~~~~~ ]
[~~~~~~~~~~~~ ]
[~~~~~~~~~~~~ ]
[       h     ]
[             ]
