[ ----  |||   ]
[ |  |  | |   ]
[ |  |  | |   ]
[ |  |  | |   ]
[ ----  |||   ]
[             ]
[~~~~~~~~~~~~ ]
[~~~~~~~~~~~~ ]
[~~~~~~~~~~~~ ]
[~~~~~~~~~~~~ ]
[       h     ]
[             ]
