[  |    |||   ]
[  |    | |   ]
[  |    | |   ]
[  |    | |   ]
[  |    | |   ]
[  |    --|   ]
[             ]
[       h     ]
[             ]
[             ]
[             ]
[             ]
