[ |     |||   ]
[ |     |||   ]
[ |     |||   ]
[ |     |||   ]
[ |     |||   ]
[ |     --|   ]
[             ]
[       h     ]
[             ]
[       h     ]
[       h     ]
[       h     ]
